5 5
4 1
3 4
0 0 0 0 0
0 1 0 1 0
0 1 1 1 0
0 1 0 1 1
0 1 0 0 0
